W W W W W W W W W W W W W W W W W W W W
W H E E E E W E E E E E E E E E E E E W
W E E E E E W E E E E E P E E E E E E W
W E E E E E W E E H E E E E E E E E E W
W H E E E E W E E E E E E E H E H E E W
W E E H E E W E E E E E E E E E E H E W
W E E E E E E E E E H H E E E E E E H W
W E E E H E E E E E H E E E E E E E E W
W E E E E E E E E E E W W W W W W W W W
W E E E E E E E H E H E E E E E E E H W
W H H E E E E E E E E E E E E E E E E W
W E E E E E E E E E E E E E E E E E E W
W E E E E E W E E E E E E E E T E E E W
W E E E E E W E E M E E E E E E E E E W
W E E E E E W E E E E E E E E E E E E W
W E E E E E W E E E E E H E W W E E E W
W E E E E E W H E E E E E E W W W E E W
W E E E E E W E E E E H E E E E E E H W
W H E E E E W E E E E E E E E E E E H W
W W W W W W W W W W W W W W W W W W W W
