W W W W W W W W W W W W W W W W W W W W
W E E E E E W E E E E E E E E E E E E W
W E E E E E W E E E E E P E E E E E E W
W E E E E E W E E E E E E E E E E E E W
W E E E E E W E E E E E E E E E E E E W
W E E E E E W E E E E E E E E E E E E W
W E E E E E E E E E E E E E E E E E E W
W E E E E E E E E E E E E E E E E E E W
W E E E E E E E E E E W W W W W W W W W
W E E E E E E E E E E E E E E E E E E W
W E E E E E E E E E E E E E E E E E E W
W E E E E E E E E E E E E E E E E E E W
W E E E E E W E E E E E E H E T E E E W
W E E E E E W E E M E E E E E E E E E W
W E E E E E W E E E E E E E E E E E E W
W E E E E E W E E E E E E E W W E E E W
W E E E E E W E E E E E E E W W W E E W
W E E E E E W E E E E E E E E E E E E W
W E E E E E W E E E E E E E E E E E E W
W W W W W W W W W W W W W W W W W W W W
