■ ■ ■ ■ ■ ■ ■ ■ ■ ■ ■ ■ ■ ■ ■ ■ ■ ■ ■ ■
■           ■                         ■
■           ■           ○             ■
■           ■                         ■
■           ■                         ■
■           ■                         ■
■                                     ■
■                                     ■
■                     ■ ■ ■ ■ ■ ■ ■ ■ ■
■                                     ■
■                                     ■
■                                     ■
■           ■                 T       ■
■           ■                         ■
■           ■                         ■
■           ■               ■ ■       ■
■           ■               ■ ■ ■     ■
■           ■                         ■
■           ■                         ■
■ ■ ■ ■ ■ ■ ■ ■ ■ ■ ■ ■ ■ ■ ■ ■ ■ ■ ■ ■
